^^^^^^^^~~^^^^^^^^^^^^^^^^^^^^^^^^^^^^^^^^^^^^^^^^^^^^^^^^^^^````▓▓▓▓▓▓▓▓▓▓▓▓▓▓▓▓▓▓▓▓▓▓▓▓▓▓▓▓▓▓▓▓▓▓▓▓▓▓▓▓▓▓▓▓▓▓▓▓▓▓▓▓▓▓▓▓▓~
^^^"""""~~^^^^^^^^^^^^^^^^^^^^^^^^^^^^^^^^^^"""^^^^^^^^^^^^^^````▓▓▓▓▓▓▓▓▓▓▓▓▓▓▓▓▓▓▓▓▓▓▓▓▓▓▓▓▓▓▓▓▓▓▓▓▓▓▓▓▓▓▓▓▓▓▓▓▓▓▓▓▓▓▓▓▓~
^^^C"^^^~~"""^^^^^^^^^^^^^^^^""""^^^^"""""""""""""""""""""""`````========▓nnnnn▓=====▓nnnnn▓=======▓nnnnnnnnnnn▓======C=▓▓~
^^^^^^^^~~"""""^^^^^^"""""""""""""""""^^^^^^"""^^^^^^^^^^^^^`````▓▓======▓nnnnn▓========================================▓▓~
^^^^^^^^~~""""""""""""^^^^^^^""""^^^^^^^^^^^^^^^^^^^^^^^^^^^^^` `▓▓======▓nnnnn▓=====▓nnnnn▓=======▓nnnnn=nnnnn▓========▓▓~
^^^^^^^^~~"""""^^^^^^^^^^^^^^^^^^^^^^^^^^^^^^^^^^^^^^^*****^^^^^^▓▓==================▓==♥==▓=======▓nnnnn=nnnnn▓♥=======▓▓~
^^^^^^^^~~""""^^^^^^^^^^^^^^^^^^^^^^^^^^^^^^**^^*********^****^^^▓▓======▓nnnnn▓=====▓=============▓nnnnn=nnnnn▓========▓▓~
^^^^^^^^~~^^^^^^^^CCC^^^^^^^^^^^^^^***^**************^*********^*▓▓======▓nnnnn▓▓▓▓▓▓▓=============▓nnnnn=nnnnn▓========▓▓~
^^^^^^^^~~^^^^^^^^"""^^^^^^^^^**^*************```****************▓▓▓▓▓▓▓▓▓nnnnnnnnnnn▓=============▓nnnnn=nnnnn▓========▓▓~
^^^^^^^^~~^^^^^^^^^"^^^^^^^^*****************`````************^**▓▓nnnnnnnnnnnnnnnnnn▓▓▓=▓▓▓▓▓▓▓▓▓▓▓nnnnn=nnnnn▓========▓▓~
^^^^^^^^~~^^^^^^^""""^^^^^^****▓*▓▓▓********``~~~``*************^▓▓nnnnnnnnnCCnnnnnnnnnn=nnnnnnnnnnnnnnnn=nnnnn▓========▓▓~
^^♥C^^^^~~^^^^^"""""""^^^^^****▓=C`▓*******``~~~~~``*************fffffffffff=Cnnnnnnnnnn=nnnnnnnnnnnnn▓▓▓=▓▓▓nn▓========▓▓~
^^^""^^^~~^^^^""""""""^^^^^****▓C===*******``==~~~``*************▓▓nnnnnnnnnnnnnnnnnnnnn=nnnnnnnnnnnnn▓=====▓nn▓========▓▓~
^^^""^^^~~^^^^""""""""^^^^******`==▓*******``~~~~~``*************▓▓nnnn▓▓▓▓▓▓▓▓▓nnnnn▓▓▓=▓▓▓nnnnnnnnnn▓=====▓nn▓========▓▓~
^^""^^^^~~^^^^^^"""""^^^^^*****▓▓▓▓▓********``~~~``**************▓▓nnnn▓==C====▓nnnnn▓==♥==================C▓nn▓========▓▓~
^^""^^^^~~^^^^^^^^"^^^^^^^^******************`````***************▓▓nnnn▓=======▓nnnnn▓=====▓nnnnnnnnnn▓▓▓▓▓▓▓nn▓=▓▓▓▓▓▓▓▓▓~
^^^"""^^^~~^^^^^^^"^"♥^^^*********************```****************▓▓nnnn▓================================================▓▓~
^^^^^""""=="""^""""""^^^^^***************************************▓▓nnnn▓=======▓nnnnn▓=====▓▓▓▓▓▓nnnnnnnnnnnnnnnn▓=====C▓▓~
^^^^^""^^~~^^"""""""^^^^^****************************************▓▓nnnn▓=======▓nnnnn▓=====▓=O==▓nnnnnnnnnnnnnnnn▓======▓▓~
^^^^"""^^~~^^^"""""^^^^^^****************************************▓▓nnnn▓=======▓nnnnn▓▓▓=▓▓▓===♥▓nnnnnnnnnnnnnnnn▓=♥=↑==▓▓~
^^"""""^^~~^^^^""""^^^^^^*^**************************************▓▓nnnn▓▓▓▓=▓▓▓▓nnnnnnnn=nn▓====▓nnnnnnnnnnnnn▓▓▓▓▓▓▓▓▓▓▓▓~
^^""^^^^^~~^^^"""^^^^^^^*****************************************▓▓nnnnnnnn=nnnnnnnnnnnn=nn▓====▓nnnnnnnnnnnnn▓CCCC=====▓▓~
^""^^^"""=="""""^^^^^^^^*****************************************▓▓nnnn▓▓▓▓=▓▓▓▓▓▓▓▓▓▓▓▓=▓▓▓▓▓=▓▓▓▓▓▓▓nnnnnnnn▓▓▓▓======▓▓~
^""""""^^~~^^^^^^^^^^^^^^****`***********************************▓▓nnnn▓=====▓=========▓=▓===========▓nnnnnnnnnnn▓======▓▓~
^^"""""^^~~^^^^^^^^^^^^^`****************************************▓▓nnnn▓===============▓=▓==============================▓▓~
^""""""^^~~^^^^^^^^^^^^^*`***************************************▓▓nnnn▓=====▓=======================▓nnnnnnnnnnn▓======▓▓~
^^^""^""^^~~^^^^^^^^^^^*``***************************************▓▓nnnn▓♥===C▓=======================▓nnnnnnnnnnn▓======▓▓~
^^""^^^"^^~~^^^^^^^^^^^`^`***************************************▓▓▓▓▓▓▓▓▓▓▓▓▓▓▓▓▓▓▓▓▓▓▓▓▓▓▓▓▓▓▓▓▓▓▓▓▓▓▓▓▓▓▓▓▓▓▓▓▓▓▓▓▓▓▓▓▓~
^^^""^^"^^~~^^^^^^^^^^^````****`*********************************▓▓▓▓▓▓▓▓▓▓▓▓▓▓▓▓▓▓▓▓▓▓▓▓▓▓▓▓▓▓▓▓▓▓▓▓▓▓▓▓▓▓▓▓▓▓▓▓▓▓▓▓▓▓▓▓▓~
^^""^^^""^~~^^^^^^^^^^``````****************************************************************************************~~~~~~~
^"""^^"""^~~^```````^```````******************************************************************************************~~~~~
^CC^^^"""^~~`````^```````````**`*********************************************`*******************************************~~
^^^^^"""^^~~~``````````````****************************************************************`******`````******************""
^^^♥""""^^^~~~~~``````````**************************`************`************``````*```````````````````````````````****```
^^^^^^^"""^^~~~~~~`````````**`*******`********************`*****``````````````*``````````▓▓▓▓▓▓▓▓▓▓▓▓▓▓▓▓▓`````````````````
^^^^^^""""^^^^^^~~``````````****`******************************````*`````````````````````▓=========▓=====▓`````````````````
^^^^"""""""""^^^^~~~``````````````****``*****`******▓▓▓▓▓▓```````````````````````````````▓=========▓==C==▓`````````````````
^^""""""""""""^C~^^~~~```````````````````````****`**▓==♥=▓▓▓▓``````````▓▓▓▓▓▓▓▓▓`````````▓===============▓`````````````````
^"""""^^"""""^^^~^^~~~~~~~`**`````````````````````*`▓====▓C=▓``````````▓=======▓`````````▓==♥=== ==▓▓▓▓▓▓▓`````````````````
^""""^^""""^^^``~~~~~~~~~~~~~**`````````````````````▓=======▓``````````▓=====▓C▓```*`````▓=========▓*****``````````````````
^^"""""""""^^♥^``^~~~~~~~~~~~~~~~~``````````````````▓====▓==▓``````````▓==♦==▓▓▓`````````▓=========▓*******````````````````
^^"""""""^^^*```^~~~~~~~~~~~~~~~~```````````````````▓====▓==▓``````````▓=====▓```````````▓▓▓▓=▓▓▓▓▓▓********```````````````
^^^^""^^^^^````````~~~~~"""~~~~~~~~`````````````````▓▓=▓▓▓▓▓▓````*`````▓=====▓```````````````"`````**********``````````````
`^``^*````*````*~~~~~~~~"↑~~~~~~~~````````````````````""```````````````▓▓▓=▓▓▓``````````````""`````````****````````````````
`*````"`^````**~~~~~~~~~~~~~~~~~~~~~~~````````````````"```````````````````"```````*``````````"`````````````````````````````
`````*````````***~~~~~~~~~~~~~~~~~~~`````````````````""```````````````````"``````````````````""````````````▓▓▓▓▓▓▓▓▓```````
``````````````````~~~~~~~~~~~~~~~~~~~*````````````````"``````````````````""``````````````````""````````````▓=======▓```````
``*``````"````````````~~~~~`***~~~~~~**```````````````""""""""````""""""""""""""""""```""""""""""````````▓▓▓=======▓```````
`▓▓▓▓▓`````````````````~~````****~~***```````````````````"""""""""""""""``""""""""""""""""""""""""""""`""==========▓```````
`▓==`▓``````````````````~~```*******``````````*`````````````````````````````````````````"""```"""""`"""""==========▓```````
`▓↑=O▓``````````````````~~````***````````````***````"```````````````````````````````````````````""```````▓▓▓=======▓```````
`▓===="``"````````````"~~```````````````````````````````````````````````````````````````````````""`````````▓=======▓```````
`▓`==▓```````"``````""==""``````````````````"```````````````````````````````````````````````````"``````````▓▓▓▓▓▓▓▓▓```````
`▓▓▓▓▓````````````````~~`"````````"````````````````````````````````````````````````````````````""````````````**````````````
`````````````````````~~````````````````````````````````````````````````````````````````````````""``````````````````````````
``````````````````````~~````````````````````````````````````````````````````````````````````````"``````````````````````````
```````""""""""""""""~~""""""""""""""""""""""""""""""""""""""""""""""""""""""""""""""""""""""========""""""""""""""""""""""
"""""""""""""""""""""~~~"""""""""""""""""""""""""""""""""""""""""""""""""""""""""""""""""""""========""""""""""""""""""""""
"""""""""""""""""""""~~~""""""~~~~~~~~~~~~~~~~~~~~~~~~~~~~~~~~~~~~~~~~~~~~~~~~~~~~~~~~~~~~~~~=====~==~~~~~~~~~~~~~~~~~~~~~~
~~~~~~~~~~~~~~~~~~~~~~~~~~~~~~~~~~~~~~~~~~~~~~~~~~~~~~~~~~~~~~~~~~~~~~~~~~~~~~~~~~~~~~~~~~~~~========~~~~~~~~~~~~~~~~~~~~~~
^~~~~~~~~~~~~~^~~~~~~~~~~~~~~~~~~~~~~~~~~~~~~~~~~~~~~~~~~~~~~~~~~~~~~~~~~~~~~~~~~~~~~~~~~~~~~=~======~~~~~~~~▓▓▓▓▓▓▓~~~~~~~
^^~~^^^^^~~~^~~~~~~~~~~~~~~~~~~~~~~~~~~~~~~~~~~~~~~~~~~~~~~~~~~~~~~~~~~~~~~~~~~~~~~~~~~~~~~~~========~~~~~~~=▓=====▓~~~~~~~
^^^^^^~^^^^^~~~~~^~~~~~~~~~~~~~~~~~~~~~~~~~~~~~~~~~~~~~~~~~~~~~~~~~~~~~~~~~~~~~~~~~~~~~~~~~~~======================▓~~~~~~~
^^^~~~^^~~^^~^~~^~~~~~~~~~~~~~~~~~~~~~~~~~~~~~~~~~~~~~~~~~~~~~~~~~~~~~~~~~~~~~~~~~~~~~~~~~~~~=====~================▓▓▓▓~~~~
^^^^^~~~~~^^^^~~~~~~~~~~~~~~~~~~~~~~~~~~~~=====~~==~~~~~~~~~~~~~~~~~~~~~~~==~~~~==~~~================~~~~~~~=▓======U~~~~~~
^^~~~~~^^~~~~~~~~~~~~~~~=~~~~~~~~~~~~~~~~~~=====~~~~~~~~~~~~~~~~~=~~~~~~~~~~~~~~~==~~================~~~~~~~=▓=========~~~~
^^O^^~~^^^^~^^~~~~~~~~~~~~~~~~~~~~~~~~~~~~~==^~~~~~~~~~~~~~~~~~~~~~~~~~~"=~~~~~~~~~~~~~~~~~~~========~~~~~~~~▓=====▓▓▓▓~~~~
~^^~~~^^~~^^~~~^~~~~~~~~~~~~~~~~~~~~~~~~~~~~=~~~~~~~~~~~~~~~~~~~~~~~~~~""""~~~~~~~~~~~~~~~~~~==~=====~~~~~~~~▓▓▓▓▓▓▓~~~~~~~
^^^^^^^^^~^^^^~~~~~~~~~~~~~~~~~~~~~~~~~~~~~~~~~~~~~~~~~~~~~~~~~~~~~~~~~""=""~~~~~~~~~~~~~~~~~========~~~~~~~~~~~~~~~~~~~~~~
~^^~^^~^^^^~~~~~~~~~~~~~~~~~~~~~~~~~~~~~~~~=~~~~~~~~~~~~~~~~~~~~~~~~~~~~~""""~~~~~~~~~~~~~~~~~======~~~~~~~~~~~~~~~~~~~~~~~
^^~~~~~~^~~~^~~~~~~~~~~~~~~~~~~~~~~~~~~~~~~=~~~~~~~~~~~~~~~~~~~~~~~~~~~~~"=""~~~~~~~~~~~~~~~~~======~~~~~~~~~~~~~~~~~~~~~~~
~~^~~~~~~~~~~~~~~~~~~~~~~~~~~~~~~~~~~~~~~~~~~~~~~~~~~~~~~~~~~~~~~~~~~~~~~""""~~~~~~~~~~~~~~~~~===~==~~~~~~~~~~~~~~~~~~~~~~~
~~~~~^~~~~~^~~~~~~~~~~~~~~~~~~~~~~~~~~~~~~~~~~~~~~~~~^~~~~~~~~~~~~~~~~~~""""~~~~~~~~~~~~~~~~~~======~~~~~~~~~~~~~~~~~~~~~~~
~~^~~~~~~~~~~~~~~~~~~~~~~~~~~~~~~~~~~~~~~~~~~~~~~~~~~~~~~~~~~~~~~~~~~~~~"CC~~~~~~~~~~~~~~~~~~~~~~~~~~~~~~~~~~~~~~~~~~~~~~~~
~~~~~~~~~~~~~~~~~~~~~~~~~~~~~~~~~~~~~~~~~~~~=~~~~~~~~~~~~~~~~~~~~~~~~~~~~~~~~~~~~~~~~~~~~~~^^~~~~~~~~~~~~~^~~~~~~~~~~~~~~~~
~~~~~~~~~~~~~~~~~~^~~~~~~~~~~~~~~~~~~~~~~~~==~~~~~~~~~~~~~~~~~~~~~~~~~~~~~~~~~~~~~~~~~~^^~~~~~~~~~~~~~~~~^~~~~~~~~~~~~~~~~~
~~~~~~~~~~~~~~~~~~~~~~~~~~~~~~~~~~~~~~~~~~~==~~~~~~~~~~~~~~~~~~~~~~~~~~~~~~~~~~~~~~~~~~~~~~~~~~~~~~~~~~~~~~~~~~~~~~~~~~~~~~
~~~~~~~~~~~~~~~~~~~~~~~~~~~~~~~~~~~~~~~~~~~=~~~~~~~~~~~~~~~~^~~~~~~~~~~~~~~~~~~~~~~~~~~~~~~~~~~~~~~~~~~~~~~~~~~~~~~~~^~~~~~
~~~~~~~~~~~~~~~~~~~~~~~~~~~~~~~~~~~~~~~~~~~~~~~~~~~~~~~~~~~~~~~~~~~~~~~~~~~~~~~~~~~~~~~~~~~~~^^~~~~~~~~~~~~~~~~~~~~~~~~~~~~
~~~~~~~~~~~~^~~~~~~~~~~~~~~~~~~~~~~^~~~~~~~~~~~~~~~~~~~~~~~~~~~~~~~~~~~~~~~~~~~~~~~~~~~~~~~~~~~~~~~~~^^~~~~~~~~~~~~~~~~~~~~
~~~~~~~~~~~~~~~~~~~~~~~~~~~~~~~~~~~~~~~~~~~=~~~~~~~~~~~~~~~~~~~~~~~~~~~~~~~~~~~~~~~~~~~~~~~~~~~~~~~~~~~~~~~~~~~~~~~~~~~~~~~
~~~~~~~~~~~~~~~^~~~~~~~~~~~~~~~~~~~~~~~~~~~~~~~~~~~~~~~~~~~~~~~~~~~^~~~~~~~~~~~~~~~~~~~~~~~~~~~~~~~~~~~~~~~~~~~~~~~~~~~~~~~
~~~^~~~~~~~~~~~^^~~~~~~~~~~~^~~~~~~~~~~~~~~~~~~~~~~~~~~~~~~~~~~~~~~~~~~~~~~~~~~~~~~~~~~~~~~~~~^~~~~~~~~~~~~~~~~~~~~~~~~~^~~
~~~~~~~~~~~~~~^^^~~~~~~~~~~~~~~~~~~~~~~~~~~=~~~~~^~~~~~~~^^~~~~~~~~~~~~~~~~~~~~~~~~~~~~~~~~~~~~~~~~~~~~~~~~~~~~~~~~~~~~~~~~
~~~~~~~~~~~~~~~~^^~~~~~~^~~~~~~~~~~~~~~~~~~==~~~~~~~~~~~~^▓▓▓▓▓▓~~~~~~~~~~~~~▓▓▓▓▓▓▓▓▓▓~~~~~~~~~~~~~~~~~~~~~~^~~~~~~~~~~~~~
~~~~~~~~~~~~~~~~~~~~~~~~~~~~~~~~~~~~~~~▓▓▓▓==▓▓▓▓~^^~~~~~~▓~==~▓▓▓▓▓▓▓▓▓▓▓▓▓▓▓~======~▓~~~~~~~~~~~~~~~~~~~~~~~~~~~~~~~~~~~~
~~~~~~~~~~~~~~~~~~~~~~~~~~~~~~~~~~~~~^~▓=====~~=▓▓▓▓▓▓▓▓▓▓▓===~~~~~~~~~~~~~~~▓========▓~~~~~^~~~~~~~~~~~~~~~~~~~~~~~~~~~~~~
~~~~~~~~~^~~~~~~~~~~~~▓▓▓▓▓~~~~^~~~~~~~▓=====~==▓~~~^~~~~~▓~===▓~~~~~~~~~~~~~▓========▓~~~^~~~~▓▓▓▓▓^~~~~~~~~~~~~~~~~~~~~~~
~~~~~~~~~~~~~~~~~^~~~~▓~C~▓~~^~~~~~^~~~▓=~======^==============▓~~~~~~~~~~~~~▓========▓▓▓▓▓^▓▓▓▓~~=▓~~~~~~~~~~~~~~~~~~~~~~~
~~^~~~~~~~~~~~~~~~~~~~▓♥==▓▓▓▓▓▓▓▓▓▓▓▓▓▓==~=====▓^~~~~~~~~▓▓▓▓▓▓~~~~~~~~^^^▓▓▓~~=====▓▓~CC~^~♥=~~=~▓~~~~^~~~~~~~~~~~~^~~~~~
~~~~~~~~~~~~~~~~~~~~^~▓~========~~~====▓▓▓▓==▓▓▓▓^^~~~~~~~^^~~▓▓▓▓▓▓▓▓=▓▓~~▓==========~=♥~^CC=▓▓~==▓~~~~~~~~~~~~~~~~~~~~~~~
~~~~~~~~~~~^~~~~~~~~~~▓▓▓▓▓~~~~~~~~~~~=~=====~~~▓▓▓▓=~▓▓▓▓^~~~▓=C==^^^==▓~^▓===~======▓▓▓^^▓▓▓▓▓▓=▓▓~~~~~~~~~~~~~~~~^~~~~~~
~~~^^~~~~~~~~~~~~~~~~~~▓~~~~^~~~~~~~~~~~~~~==~~~▓~==~=▓~~▓~~~~▓~==~~^▓===~~==~~======~▓~~^~~~~~~==▓^~~~~~~~~^~~~~~~~~~~~~~^
~~~~^~~~~~~~~~~~~~~^~~~▓~~~~~~~====~~~~~~~~=~~~~▓♥=~==~~====~~▓=~~~~~▓▓▓▓~^▓▓▓▓▓▓▓▓▓▓▓▓=======~~~~▓~~~~^~~~~~~~~~~^^~~~~~~~
~~~~~~~~~~~~~~~~~~~~~^~▓~~~~~~~=============~~~~▓~~=====~▓~~~~~~~~~~==~~▓^~~~~▓~==~~~~~==^~==~~~~~▓~~~~~~~~~~~~~~~^~~~~~~~~
~~~~~~~~~~~~^^~~~~~~~~~▓~^~^~~~====~~~~~~~~==~~~▓▓▓▓▓▓▓==▓~=~~▓~~=~~~=~~▓~~~^~▓==▓^~~~==^^=====~~~▓~~~^~~~~~~~~~~~~~~~~~~~~
~~~~^~~~~^~~~~~~~~~~~~▓▓▓▓▓~~~~~~~~~~~~^~~~^~~~~~~~~~~▓==▓~=~~==~~~~~~~==~~~~~▓~~▓~~~~==^^====~▓▓▓▓▓~~~~~~~~^~~~~~~~~~"""~~
~~~~~~~~~~~~~~~~~~~~~~▓C~~▓~~^^~~~~~~~~~~~~==~~======~==~▓^~~~~~~=^▓~~~~~^~~~~^=♥▓~~====^==~~~~▓~~^▓~~~~~~~~~~~~~~~~""""""~
~~^~~~~~~~~~~~^~~~~~~~▓~C~▓~~^~~~^^~~~~~~~~~~~~~~~~~~~▓~~^^~~^^~~^~~~=^~~~^~~~===▓~~~=====~~^~=^==~▓~~~~~~^~~~~~~~~~"""B""~
~~~~~~~^~~~^~~~~~~~~~~==~~▓▓▓▓▓▓▓▓▓▓▓▓▓▓▓^▓▓▓▓▓▓▓▓▓▓▓▓▓▓▓▓▓▓▓▓▓▓^^^^^^^^▓▓^▓▓▓▓▓▓▓▓▓▓▓▓▓▓^▓▓▓▓▓▓~^~▓~~~~^^~~~~~~~^~~~"""""~
~~~~~~~~~~~~~~~~~~~~~~▓▓▓▓▓~~~^^~~~~~~~~~^~~~~~~~~~~^~~~~~^~~~~^^~~~^~~^^^~~~~^^^~~~~~^^~~^~~~~▓▓▓▓▓~~~~^~~~~~~~~~~~~~~~~~~